For the kids (easy)

############
#         .#
#@ $$$    .#
#         .#
############

      ####
      #  #####
 ######      #
##    # ###  #
#@ $$$# ### ##
##          #
 ######.##  #
      #.#####
      #.#
      ###

 ####         ####
 #  ###########  #
##  $    #    $  ##
# .##$$  #  $$##. #
#@..#    #    #.. #
#####  #   #  #####
    ###########

   #### ####
  ##  ###  ##
 ##   #@#   ##
 #  ..   ..  #
 # $$$$$$$$$ #
 ###       ###
   ##  #  ##
    ##   ##
    # .#. #
    # ... #
    #######

   ####    #####
   #..######   #
   #...    $   #
   #.. ###### ##
   ##  #    # #
    # ##    # #
    #@#  ####$##
 ####$#### $   #
 #             #
 # #$ $#########
 # #   #
 # ##$##
 #    #
 ######

#############
##   ....   #
#   ##   #  #
#   ######$##
##  #  #   #
 # ##### ###
 #       #@#
 # #### $  #
 #   $  $# #
 #######   #
       #####

#######
#. $ .#
## # ##
#. $ .#
# $ $ #
#.# #.#
# $ $ #
#.# #.#
# $ $ #
#.# #.#
# $ $ #
#  @  #
#######

 #######
##  .  ##
# .$@$. #
#  $#$  #
# .$ $. #
##  .  ##
 #######

  #########
  #.##.##.###
 ## $  $  $ #
## $  $  $  #
#@$ .$ .$ . #
###.##.##.###
  #########

###     ###
#.#######.#
#   $.    #
#$# # #$# #
# #@# # # #
# #$# # #$#
#    .$   #
#.#######.#
###     ###

