Test
description…

#####
#@$.#
#####

######
#@ $.#
######

#######
#@  $.#
#######
